###############
#S##__________#
#_##___1______#
#D##PP+___B_BB#
#RRD__+______B#
#RRD__+_1_____#
#_######_######
########P######
#_##_C__#__C__#
#_##__________#
#G##___C_C____#
#G##_________*#
###############